######                                                                                                                                                                                    #
#                                                                                                                                        450                                         #
#                                                                                                                                         |                                          #
#                                                                                                                                         |                                          #
#                                                                                      475  483  497                           439  426  425  478                                    #
#                                                                                       |    |    |                             |    |    |    |                                     #
#                                                                                       |    |    |                             |    |    |    |                                     #
#                                                                                 470--473  464--493                           386--360  409  383  419                               #
#                                                                                  |         |                                  |    |    |    |    |                                #
#                                                                                  |         |                                  |    |    |    |    |                                #
#                                                                                 468  467  455  491       443       406--391  387  328--362  323--405  476                          #
#                                                                                  |    |    |    |         |              |         |         |         |                           #
#                                                                                  |    |    |    |         |              |         |         |         |                           #
#                                                                                 420--331  418  474       438  415  384  327--320  242  313--321--394--416                          #
#                                                                                  |    |    |    |         |    |    |         |    |    |              |                           #
#                                                                                  |    |    |    |         |    |    |         |    |    |              |                           #
#                                                                                 428  318  372--382--408--268  333  351  307--204  226--214--220  399  429--442                     #
#                                                                                       |    |              |    |    |         |         |    |    |                                #
#                                                                                       |    |              |    |    |         |         |    |    |                                #
#                                                                            441--373  315  329  370  293--259--301  174  231  186  181--201  257--298  454--435--488                #
#                                                                                  |    |    |    |         |         |    |    |    |              |         |                      #
#                                                                                  |    |    |    |         |         |    |    |    |              |         |                      #
#                                              471                           477  349  261--277  312--219  203  153--139--124  178  177  234--297  377--412  432--433--434--446      #
#                                               |                             |    |    |              |    |              |    |    |    |    |              |                      #
#                                               |                             |    |    |              |    |              |    |    |    |    |              |                      #
#                                              440  499--465                 444--347--237--207  175--121  126  157--133  093--143  170--198  304--337--389--396--413--436           #
#                                               |         |                                  |         |    |         |    |         |         |                   |                 #
#                                               |         |                                  |         |    |         |    |         |         |                   |                 #
#                                         332  381  397--427--451       485--369--330  188--158  120  113  083  107  117  089--131--148--189  379  371--411--417  469                #
#                                          |    |    |                             |         |    |    |    |    |    |    |                        |                                #
#                                          |    |    |                             |         |    |    |    |    |    |    |                        |                                #
#                                         322  292  286  380  272  356  278  354  238  206  104--091  098  040  039  074  081--090--094  209--248--335  376  400  472  490           #
#                                          |    |    |    |    |    |    |    |    |    |         |    |    |    |    |    |              |              |    |    |    |            #
#                                          |    |    |    |    |    |    |    |    |    |         |    |    |    |    |    |              |              |    |    |    |            #
#                                    287--276--273--227  221--235  239  199  271  179  125--064  084--030  023--036  051--063--078--101--108--249--264--309  325--398--437           #
#                                          |         |    |         |    |    |    |         |         |    |         |    |                                  |                      #
#                                          |         |    |         |    |    |    |         |         |    |         |    |                                  |                      #
#                          496--457--361  341  289--225--218  180  210--159--138  135  069  052  061  014--018--022--050  076--077--106  192--294  290--302--317--385--460           #
#                                     |                   |    |              |    |    |    |    |    |                                  |         |         |    |    |            #
#                                     |                   |    |              |    |    |    |    |    |                                  |         |         |    |    |            #
#                                    357--270--252--156--129  137--171  140  127--079--056--047  009  008--017--020  048  066--092  190--191--194--211--258  348  480  463           #
#                                                         |    |         |                   |    |    |              |    |         |         |                                     #
#                                                         |    |         |                   |    |    |              |    |         |         |                                     #
#                                    482--285--176--128--116--111--110--102--087--071  067--007--006--002--004--038--043--053--068--103  169  224  254--275--453                     #
#                                               |              |    |              |                   |                                  |         |                                #
#                                               |              |    |              |                   |                                  |         |                                #
#                                    449--402--245  267--166--165  185  088  070  049--035--011--003--000--001--021  029--033--042--059--132--212--253--310--424                     #
#                                                         |              |    |              |    |    |              |    |              |         |                                #
#                                                         |              |    |              |    |    |              |    |              |         |                                #
#                                              336--251--205  147--142  060--057--045--028--027  015  005--010--016--025  044--073--097  173--182  306--366--375                     #
#                                                         |         |    |         |    |         |    |    |                                  |                                     #
#                                                         |         |    |         |    |         |    |    |                                  |                                     #
#                                              342--266--233  223--105--072  065--062  034  024--019  012  013--026--058--075--080--099--172  308  274--340--445--462                #
#                                                                        |         |         |         |    |         |    |    |    |              |    |                           #
#                                                                        |         |         |         |    |         |    |    |    |              |    |                           #
#                                              395--326--280--184--144--119  109--095  041--037  046--031  032--086  100  123  134  122--145--215--243  346--390--456                #
#                                                              |         |         |    |    |    |    |    |    |    |              |    |    |              |                      #
#                                                              |         |         |    |    |    |    |    |    |    |              |    |    |              |                      #
#                                              368--359--217--193  228--136  150--118  112  055  054  085  082  096  146--161  164--155  339  316--355--365  486                     #
#                                                         |    |              |         |         |                        |    |                                                    #
#                                                         |    |              |         |         |                        |    |                                                    #
#                                         487--311--296--263  197  229--160--152  151--115  141--114--130--167--200  244--187  183--216--319--344--392                               #
#                                                    |                   |              |         |         |    |         |    |              |    |                                #
#                                                    |                   |              |         |         |    |         |    |              |    |                                #
#                                         484--448--352--378  299--265--208  162--154--149--196  163--168  202  255--260  213  262--282--314  414  430--458                          #
#                                                         |         |    |         |    |    |    |         |    |    |         |    |              |                                #
#                                                         |         |    |         |    |    |    |         |    |    |         |    |              |                                #
#                                                        423  407--291  232  240--195  230  222  256  279--247  281  284--345  283  305--343--431  461--481                          #
#                                                                   |    |    |    |    |    |         |    |    |    |    |         |    |    |                                     #
#                                                                   |    |    |    |    |    |         |    |    |    |    |         |    |    |                                     #
#                                                                  422  334  303  236  246  241--374  388  288  295  363  358  452--353  401  479                                    #
#                                                                        |         |    |                   |    |         |              |                                          #
#                                                                        |         |    |                   |    |         |              |                                          #
#                                                                       404  350--250  269--338--403--367--324  300--364  494            421                                         #
#                                                                        |    |    |                                  |                                                              #
#                                                                        |    |    |                                  |                                                              #
#                                                                       492  410  393--466                 498--459--447                                                             #
#                                                                                       |                        |                                                                   #
#                                                                                       |                        |                                                                   #
#                                                                                      495                      489                                                                  #
#                                                                                                                                                                                    #
#####